1
140
150
8
0.6
0.6
0
0
3
319.5
1.92
5
10
1 1 1 1 2 2 1 1 1 1
1 1 1 2 9 9 2 1 1 1
1 1 2 9 9 9 9 2 1 1
1 1 1 2 9 9 2 1 1 1
1 1 1 1 2 2 1 1 1 1
