1
140
150
8
1.6
1.6
0
0
3
319.5
1.92
5
10
1 1 1 1 1 1 1 1 1 1
0 1 1 2 2 2 2 1 1 0
0 0 1 1 2 2 1 1 0 0
0 0 0 4 1 1 4 0 0 0
0 0 0 0 3 3 0 0 0 0
